NO ./texture/bound_north.xpm
SO ./texture/bound_south.xpm
WE ./texture/bound_west.xpm
EA ./texture/bound_east.xpm

F 111,237,255
C 0,255,0

        1111111111111111111111111
        1000000000110000000000001
        1011000001110000000000001
        1001000000000000000000001
111111111011000001110000000000001
100000000011000001110111111111111
11110111111111011100000010001
11110111111111011101010000001
11000000110101011100000010001
10000000000000001100000010001
10000000000000001101010010001
1100000111010101111101111N00111
11110111 1110101 101111010001
11111111 11111111111111111111
