NO ./texture/test1.xpm
SO ./texture/wall.xpm
WE ./texture/wall_big.xpm
EA ./texture/tile.xpm

F 0,255,0
C 225,30,0

11111111111111111111111111111111
1                              1
1           1111111111         1
1           1000000001         1
1           1000000001         1      111111111
1           1000000001         1      100000001
1           1000000001         1      1000N0001
1           1000000001         1      100000001
1           1000000001         1      100000001
1           1000000001         1      111111111
1           1000000001         1
1           1000000001         1
1           1000000001         1
1           1111111111         1
1                              1
11111111111111111111111111111111