NO ./texture/test1.xpm
SO ./texture/wall.xpm
WE ./texture/wall_big.xpm
EA ./texture/tile.xpm

F 0,255,0
C 225,30,0

11111111111111111111
10000011111111000001
10000000011100000001
10000000000000000001
10000001111111000001
10000000000001000001
100000000N0001000001
10000000000001000001
10000000000000000001
11111111111111111111